
###############
#             #
# # ####### # #
# # #       # #
############# #
# #     #   # #
# # # # # ### #
#   # # #     #
# ##### # ### #
#     # # #   #
# # # # # ### #
# # # # #   # #
# # ### ### # #
# # #       # #
###############