
         ###############
         #     #       #
         # ### # ##### #
         # #   # #     #
START-->   # ### # # ###
         # #     # #   #
         # ####### # # #
         # # #   # # # #
         # # # # # ###   <--END
         # #   #   #   #
         ########### # #
         #   #     # # #
         # # # # # # # #
         # #   # #   # #
         ###############