
         #############################################################################
         #     #                                 #                 #         #   #   #
         # ### # ### # # # ##### # # ### ####### ######### # # ### ##### # ### # # # #
         #   #   #   # # # #     # # #   #     #           # #   #       # #   #   # #
         # # ##### ##### # # ####### # ### ### ### ######### # # ######### # #########
         # #     # #     # # #   #   # # #   #   #   #   #   # #       #   #         #
         # ####### # ####### # # # # # # ### ### ### # ### # # ####### # ##### ##### #
         #   #     #   #   # # # # # # # #   #   #   #   # # # #   #   # #   #   # # #
         ### # ######### # # # # # ### # # ### ### ##### # ### # ### # # # # ### # # #
         #   #   #       # #   # #   #   # #   #   #   #   #   #     # #   #   # # # #
         # # ### # # ### # # ### # # ##### # # # ##### ##### ######### ##### # # # # #
         # # #   # #   # # # #   # #       # # # #     #     #         #   # # #   # #
START-->   ### ### ### ### ### ### ######### # # # # ### # ### ### ##### # ### ##### #
         #   #     #   #   #   #   #         # #   #   # # # #   #     # #   #         <--END
         # # ### ####### ### ####### ####### # ### ##### # # # # ##### # ### # #######
         # #   # # #     # #       #   #   # #   # #     #   # # #     # #   #     # #
         # ### # # # ##### ####### ### ### # ### # # ######### # ### ### # # ##### # #
         #   # #   # #   # #     # #   #   # #   # # #   #     #   # #   # #     #   #
         ### # ##### ### # # ### # # ### ### # ### # # # # ####### ### ### ######### #
         # # #     #   # # #   #   #     #   #   # # # # #       #     # #     #   # #
         # # # ### ### # # ### ################# # # ### ############### # ### # # # #
         # # #   #   #   #     #   #   #         # #     #             # #   #   # # #
         # # # # # # ############# # # # # ####### ##### # ########### # ######### # #
         #   # # # #   #       #   # #   # #     #     # #     #     #   #   #     # #
         ####### # ### # ##### # ### ##### # ### ##### ####### # # # ##### # # ##### #
         # #     #   #   #   # # # #     # #   #     #         # # # #   # # # #     #
         # # # ##### ##### # # # # ##### # ### ##### ########### # # # # # # # # #####
         #   #     #       # #   #       #   #     #             # #   #   #   #     #
         #############################################################################