
         ###############
         #   #         #
         # # ######### #
START-->   #           #
         # ####### # ###
         #       # #   #
         ##### # # ### #
         #     # #   # #
         # ##### # # ###
         # #     # #   #
         ### ######### #
         # # #       #   <--END
         # # # ####### #
         #   #         #
         ###############