
         ###############
         #             #
START-->   # ######### #
         # #   #       #
         # ### ##### ###
         #   #     #   #
         ### ##### ### #
         # # #   #   # #
         # # # ##### ###
         # # #     #     <--END
         # # ##### ### #
         # #     #   # #
         # ##### # # # #
         #       # #   #
         ###############