
         ###################################################################################################
         #           #   #     #                             #           #           #   #                 #
         # # ######### # # # ### # # ####### # ####### # ### # # # ### # # # ####### # # ##### ##### # ### #
         # #       #   #   #     # #   #   # # #       # #   # # #   # #   #       # # #       #   # #   # #
         # ##### # # # ########### ### # # # # ########### # # # ### # # ####### # ### ##### # ### # ### # #
         # #   # #   #           #   # # # # #       #     # # #   # # #   #   # #   # #   # # #   # # # # #
         # # # # ######### # ### ### # ### ######### # ####### ##### # ##### # ##### # # # # # # ### # # # #
         #   # #     #   # #   #   # #   #       #   # #   #   #     #       #     # #   # # # #     #   # #
         ##### ##### # # # ####### # # # ### ### # ##### # # # # ################# # ##### # ##### ####### #
         #     #   #   # #   #   # # # #   #   # # #     #   # # # #   #           #       #     #       # #
         # ##### # # ### ### # # ### # ### ##### # # # ####### # # # # # # ### ### ######### ### # ####### #
         # #   # # #   # #   # # #   #   #     #   # #   #   # # # # #   #   #   # #       #   # # #   #   #
         # # # # # ##### # # # ### ##### # ### # ### ### # # ### # # # ##### ### ### # ### ### # # ### # # #
         #   #   # #     # # #     #     # # # # #   #   # #     #   #     #   # #   #   #   # # #     # # #
         ######### # ##### # ####### ##### # # ### ### ### # # ########### ### # # ######### ### # ##### # #
         #     #   # #   # # # #     #     # #   # #   #   # # #     #     #   #   #   #   # #   # #     #   <--END
         # ### ##### # # # # # # ##### # ### ### # # ### ### # # ### # ##### ### ### # # # # # ### # #######
         #   # #     # #   # # # #   # #   #   # # #   # #   #   #   #     #   #   # #   #   #   # #       #
         ### # # ##### # ### # # ### # ####### # # ### # ######### # ######### ##### ##### ##### # ####### #
         #   # # # #   # #   # #     #         # #   # # #     #   # #   #   #     #     #   #   # #     # #
         # ### # # # # # # ### ############### # ### # ### ### ####### # # # ##### ##### ### # ##### ##### #
         #   # # #   # # #     #       #     # #     #   # #   #   #   # # #     # # #   #   # #   # #   # #
         # # ### ##### # ####### # ### # # # ########### # # ### # # ### # ####### # # ### # # ### # # # # #
START-->   #     #     #         #   #   # #           #   #     #   #   #         #   #   # #     #   #   #
         ###################################################################################################