
         ###############
         #   #         #
         # ### #########
         #   #     #   #
         ### ##### # # #
         #   #   #   # #
         # ### # ##### #
         # #   # #   # #
         # # # # # # # #
         # # # #   #   #
         # # # ####### #
         # # #       #   <--END
START-->   # ####### # #
         #   #       # #
         ###############