
         ###############
START-->           #   #
         # ##### # # #   <--END
         # #   # # # # #
         # ### # # # # #
         #     # #   # #
         # # ### ### # #
         # #   #   # # #
         # ### ### ### #
         # #   #   #   #
         # # ### ### ###
         # #   #   # # #
         # ######### # #
         #         #   #
         ###############