
         ###############
         #     #   #   #
         # # # # # # # #
         # # #   # # # #
START-->   # ####### # #
         # #   #   # # #
         # ##### # ### #
         #     # # #     <--END
         # # # # # # ###
         # # #   # #   #
         # ####### ### #
         #       # #   #
         ####### # # # #
         #       #   # #
         ###############