
###############
#             #
##### # ##### #
#     #     # #
# ######### # #
#     #   # # #
### # # ### # #
#   # #     # #
# ### ####### #
#   #     #   #
####### # # ###
#     # # #   #
# ### ### ### #
#   #     #   #
###############