
###############
# #   #   #   #
# # # # # # ###
#   # #   #   #
# ##### ### # #
# # # # # #   #
# # # # # #####
#   #   # #   #
# # # # # ### #
# # # # # #   #
# ### # # # ###
# #   # #     #
# # # ### # # #
#   #   #   # #
###############