
         ###############
         #   #         #
START-->   # # ####### #
         # #   #       #
         # ##### #######
         # #     #     #
         # ####### ### #
         #       #   #   <--END
         ####### ### # #
         #     #     # #
         # ### # ##### #
         # # # # #   # #
         # # # ### # # #
         #   #     #   #
         ###############