
         ###################################################################################################
         #               #       #       #   #     #   #         #                       #           #     #
         # ##### ######### # # ### # ##### # # ### # # # # ### ### # ############### ##### # ### # # # # # #
         # #   #         # # # #   #       # #   #   #   # #   #   #               # #     # #   # # # # # #
         # ### # # ##### # # ### ########### ### # ####### # ### # # ##### # ##### # # ####### # # ### # # #
         #     # #     #   #     #         #     #   #   # #   # # # #   # # # #   # # #     # # #     # # #
         # ##### # ### # ################# # # ####### # # ##### # # ### # # # # ### # # ### # # # ##### ###
         # #     #   # # #       #         # #     #   #   #     # #   # # #   #   # # #   # # # # #   #   #
         # # ##### # # ### # ### # ####### # # ### # ####### ##### # # # # ####### ### ### ### # ### ##### #
         # # #   # # #     #   #   #     # # # #   #         #   # # #   #       #   #   #   # #   # #   # #
         # # # # # # ######### ##### ### # # # # ######### ### ### # # ### ##### # # ### # # # # # # # # # #
         # #   # # #   #     # #   #   # # # # # #       #   #     # #   #   #   # # #   # #   # #   # # # #
         # ##### # ### # # # # # # ### # ### # # ####### ### ####### ### ##### ### # # ### # ######### # # #
         #   #   #   #   # # #   # #   #     # #         #   #     # #   #     #   #   # # # #       # # # #
         ##### # ### ##### # ##### # ####### # ########### # # ### # ##### # ####### ### # # # ##### # # # #
         #     #   #     # #   #   # #     # #   #       # # # #   #   #   #   #   #   #   # #     #   # # #
         # ### ######### ##### # # # ### # ##### # ### # # ### # ##### # ####### # ########### ### ##### # #
         #   #   #     #     # # # #   # #       #   # # #     # #   # #       # #     #       #   #   #   #
         ### # ### ### ### ### # ### # ### ######### # # ####### # ### # ##### ####### # ### ### ### # ### #
         #   # #   # #   # #   #   # #   # #         # #         #     #     #         #   #   # #   #   # #
         # ### # # # ### # # ##### # ### # # ################# ##### ####### ############# ### # # ##### # #
         # #   # # #     # # #     # #   # # #               #     # #     # #       #     #   # #     # # #
         # # ### # ######### # ##### # ### # ########### ### ##### # # # # # # # ### # ### ##### ####### # #
         # #   # #     #   # # #   # # #   #           # #   # #   # # # # # # #   # #   # #   #   #   # # #
         # ### # ##### # # # ### # ### # # # ####### # ### # # # ### # ### ### ### # # # ### # ### # # # # #
         # #   #     # # #   #   #     # # #   #   # #     # # #   # #   #     #   # # #     # #   # # # # #
         # ######### # # ##### ######### # ##### # ######### # ### ### # ####### ### ######### # ### # # # #
         # #         # #   #   #   #     #       #   # #     #   #   # #       #   #           #     # # # #
         # # ######### # # # # # # # # ############# # # # ### # # # ### # # # ####### ### ########### # ###
         # # #   #     # # # # # #   #     #     #   #   #   # # # #   # # # #   #   #   #       #   # #   #
         # # # # # # ##### # ### ######### # # # # # ####### ### # ### # # # ### # # ### # ##### ### # ### #
         #   # #   # #   # #   #   #     # # # #   #   #   #   # # #   # # #   #   #   # # #   #     #   # #
         ##### # ##### # # ### ### # ##### # ######### # # ### # ### # # # ### # ### # # ### # ######### # #
         #   # # #     # #   # #   #       #   #       # #     #     # # # # # #   # # # #   # #     # #   #
         # # # ### # ####### # ############### ######### ######### ##### # # # # # # # # # # # # # # # # ###
         # #   #   # #       #   #         # #     #     # #     #   #   #   # # # # # #   # # # # #   #   #
         # ##### ##### # ##### # # ####### # ##### # ##### # ### # ### # ##### # # # # ##### # # ###########
         #     #       #     # #   #   #   #       #     #   #   # #   # #   # # # # #     # # # #         #
         # # # # ########### # ####### # ############### ##### ##### ### # # # # # ##### # # # # # ####### #
         # # # # #         # #         # #   #     #   # #   #   #   #   # #   # #     # # # #   # #     # #
         # ### # # ####### # ########### # # # # # ### # # # ### # # # ### ##### ##### ### # ##### ##### # #
         # #   # # #   #   # #     #   #   #   # #   # # # #   #   # #   #     #     #   # #     #   #   # #
         # # ##### # # # # # # # # # # # ####### ### # # # ### ##### # # ### # ####### # # # ### ### # # # #
         # #   #   # #   # # # # #   # #       #   # # # # #   # #   # #   # # #     # # # #   #   #   # # #
         # ### # ######### # # # ##### ########### # # # # ### # # ####### ### # # # ### # ### ### ####### #
         #   # #         # #   # #     #   #     # # # # #   # #   #     #   # # # #   # #   #   #         #
         ### # ##### ### ### ### # ##### # # ### # # # # ### # ### # ### ### # # ##### # ### # # ######### #
         # # #     # # #   # #   #       #   #   # # #   #   #   # # #   # # # # #     #   # # #     #   # #
         # # # # # # # ### ### # ### ######### ### # ##### # ### # # # ### # # ### # ####### # ##### # # # #
         #   # # # #   #   #   #   #     #     #   #     # #   # # # #     # # #   #   #     # #   # # # # #
         ##### # # ##### # # ##### ####### ##### # # ### # # # # ### ####### # # ####### ##### # # # # # ###
         #   # # #       # #     # #     # #   # # #   #   # # #   #         # #       #     #   # # # #   #
         # ### # ######### ##### ### # # # # # # # ### ##### # ### # ######### ##### # # ### ##### # ##### #
         #     #     #   # #     #   # #   # #   #   # #     # #   #   #     #     # # #   # #   # #   #   #
         # ######### # # # # ##### ######### ####### # ####### # # ### # ######### ### ### # # ### # # # ###
         # #     #   # #   #     # #       #   #   # # #     # # # #   # #       #     #   # #     # # # # #
         # # ### # # # ######### # ##### # ### # # # # # # # # # # # # # # # ### # # # # ### # ##### # # # #
         # # # # # # # # #   #   #     # #   # # #   # # # # # # # # # #   # #   # # # # #   #   #   #   # #
         # # # # # # # # # ### ####### # ### # # ####### # # ### ### ######### ### # ### ######### ####### #
         # #   #   # #   #     #     # #   #   #     #   # #   # #   #   #     #   #   #         #       # #
         # ##### ### ########### ### # # # ########### ####### # # ### # # # ### ##### # ### # # ##### # # #
         #     #   #   #       #   #   # #     #       #     #   #     # # # #   #     #   # # #     # #   #
         # ### # # ### # ##### ### # # # ####### # ##### ### ######### # # ### # # # ####### # ### # ##### #
         #   # # #   # #   #   # # # # #     #   #   #   #   #       # #   #   # # # #   #   #   # #     # #
         ### # # ##### ### # ### # # ######### # ##### ### # # ### # ####### ##### # # # # ####### ### # ###
         #   # #   #   #   #     # # #         # #     #   # #   # #     #   #     #   # #       #   # #   #
         ##### ### # ### # ####### # # ########### # ### # # ### ####### ####################### # # ##### #
         #     #   #     # # #   # # #     #   #   # #   # #   #   #   #   #             #   #   # # #     #
         # ############### # # # # # ##### # # # ##### ### ### # # ### # # # # ######### # # # # # # # #####
         #     #         #   # # # # #   #   #   #     #   #   # #     # #   #     #     # #   # # # #     #
         ##### # ####### ##### # # ### # ### ##### # ### ### ### ### ### # ####### # ##### # ##### # #######
         #   # #     #   #     # # #   #   #     # # # #   # # #   #   # #   #     #       #   #   #   #   #
         # # # ##### # # # ####### # ##### ####### # # ##### # ### ##### ### # ################# # ### # # #
         # # #       # # #   #     #     # #       # # #     #     #     # # #     # #           # #   # # #
         # ### ####### ##### # ### ### # # # # # ### # # ########### # ### # # # # # # ########### # ### # #
         #   #     #   #     #   #   # # # # # #   # # # #       #   #   #   # # #   #         #   #   # # #
         # # ### # # # # ####### ### # # ### # ##### # # ####### # ##### ##### # # ####### ### ####### # ###
         # #   # # # # #     #   #   # #     # #   #   #   #   # #   #   #     # # #     # #   #       #   #
         # ### ### # ### ### # ####### ######### # ##### # # # # # # ##### ##### ### ### # # # # ######### #
         #   #   # #   # # #   #     # #   #     #     # # # #   # #   #   #   #     # # # # # #   #   #   #
         ### # # ##### # # ##### # # ### # # # ####### # # # ##### # # # ##### ####### # # # # ### # # # #   <--END
         #   # # #   # #   #   # # #   # # # #       # # # # #     # # #       #     #   # # #   #   # # # #
         # ##### # # # # ### # # # ### # # # # ##### # ### # # ####### # ########### ##### # # # ##### # # #
         # #   #   # # #   # #   #   # # # # #   #   #     # # #       # #     #     #     # # #     #   # #
         # ### ##### # ##### ####### # # # # ### # # # ##### ### ####### # ### # ### # # ### ####### # ### #
         #   #   #   # #   #   #   # #   #   #   # # # #     #   #     # #   # #   # # #   #     #   # #   #
         ### # # # # # # # ### # # ############### # # # # ### ### ### # ### # # # ### ####### # ####### ###
         #   # # # # # # #   #   #   #   #         # # # # #   # #   # #     # # #     #   #   # #     #   #
         # ##### # ### # ########### ### # ######### # # ### # # ### # ####### # ####### # # # # # # # ### #
         #   #   #     #   #         #   #   #     # # #     # #     #     #   # #   #   #   # #   # #   # #
         ### # ########### # ##### ### ##### # ### # ############### ##### # ### # # # ############# ##### #
         #   # #           #     #   #     #   #   #     #     #   #     # # #   # # #   #     #   # #     #
         # # # # ##### ######### # # ### # ##### # ##### ##### # # ####### # # ### # ### ##### ### # # #####
         # # # # #   # #     #   # #   # #   #   #   # #     # # # #       # # #   # #   #   #   # # # #   #
START-->   ### # # # ### # # # ### ### # ### # ##### # ##### # # # # ##### # # # # # # ### # ### # # # # # #
         # #   #   #     # # # #   #   #   #   #   #   #   #   # # # #   # # # # # #   #   # #   #   #   # #
         # # ############# # # # ### ########### # ##### # ####### # # # ### # # ####### ### # ########### #
         #   #             #   #   #             #       #         #   #     # #         #   #             #
         ###################################################################################################