
         ###################################################################################################
         #         #                             #           #                             #               #
         # ### # # ### # ### # ####### # # ##### # ### # ### # ### # # ### ##### # # ##### # # ####### ### #
         # #   # #     # #   # #   # # # # #   # # #   #   # #   # # #   #   # # # #     #   # #     #   # #
         # # ### ####### # ##### # # # # # # # # # # ##### # ### # # ### # # # # # ### # ### ### # # ### # #
         # #   #       # #       # #   # #   # #   # #     #     # # #   # #   # #   # #   # #   # #   # # #
         # # # ####### # # ####### # ### ####### ### ######### ### ### ######### # # # ### ### ### # # ### #
         # # #     #   # # #   #   #   #   #   #   #         # # #   #     #     # # #   #     #   # #   # #
         # ####### # ### # # # # ######### # # ### # ####### # # # # ##### # ####### ########### # # ### ###
         # #   #   # #   #   # #         #   # #   #   # #   #   # #   #   # #       #     #     # # # #   #
         # # ### ### ### ##### ######### ##### ##### # # # ############# # # ######### # # # ##### # # # # #
         # #   #   #   # #   # #         #   # #   # #   # #     #   #   # #   #       # # #   #   #   # # #
         # ### # # ### # # ### # ######### # # # # # ### # ##### # # # # # ### # ##### ### ### ######### # #
         #   # # # #   # #     #         # # #   # #   # #       # #   # #   # # #   # #   #   #       # # #
         # # # # # ##### ### ##### ##### ### ##### # # ### ####### ########### # # # # # ### ### ##### ### #
         # # # # #   # #   # #   # #   #   #   #   # #   # #     #           # # # # # #   # #   #     #   #
         ### # ##### # ### # ### # # ##### ### # ####### # # ##### ### ### # # # # # ##### # ##### # ### ###
         #   #     # #     #     # #       #   #     # # # #     #   #   # # #   # # #     # #     # #   # #
         # ### # # # # ### ####### ##### ### # ##### # # # ##### ### ### # # ##### # # # # # # ##### # # # #
         #   # # #   #   # #   #   #   # # # # #     # # #       #   #   # #   #   #   # # # # # #   # # # #
         ### # ######### # # # # ### # # # # ### # ### # # ##### # ##### ##### ### ##### ### # # # ### ### #
         #   #   #     # # # # # #   # #   #     #   #   #     # # #   # #   #   # #   #   #   # #   #     #
         # ### # ##### # # # ### # ### ######### ### # # ##### ### # # # # ##### # # # ### ##### ### # #####
         #   # #       # # #     # #   #       # #   # # #   # #   # # # # #   # #   # # #   # #   # #     #
         ### # ######### # # ##### # ### ##### # # ### ### # # # ### # # # # # # # ### # ### # ### # # ### #
         # # #       #   # # #   # # #   #     # # #   #   # # #     # # #   #   # # # #   #   #   # #   # #
         # # ######### ### # # ### # # ### # ### # # ### ### # ####### # ####### # # # ### # ### ### ### # #
         #   #   #     #   # # #   #   #   #   # # #   #   # # #     # # #     # #   # #   #   #     #   #   <--END
START-->   ### # # ######### # # ####### ##### # # ### ### # ### ### # # # ### # ### # # ### # ########### #
         # #   #   #       # # #   #   # #   # # #   #   # #   #   #   #   #   #   # # #   # #       #     #
         ### ####### ##### # # ### # # # # # # # ### ##### # # ### ######### # ### # # ### ##### ##### #####
         #   #     # #   # #   #   # #   # #   #   # #     # #     #       # # #   # # #   #   #   #   #   #
         # # # ### ### # # ##### ### ##### ######### # # ### # ##### ##### # ### ##### # # # # ### # ### # #
         # # # #   #   #   #   # #   #   # #       # # #   # #   #   #     #   #     #   # # #   # #   # # #
         # # # # ### # ##### # # # ### # ### # ### ### ### # ##### ### ####### # ### ##### # ### ##### # ###
         # # # #     # #     #   #   # #     # #   #   #   # #     #   #     # #   #   #   # #   #     #   #
         # ### # ####### ### # ##### # ####### # ### ### ### # ##### # # ### # ### ### ##### # # # ### ### #
         #   # # #     #   # # #   #   #   #   #   #   # # # # #     # # # # # #   # # #     # # #   # #   #
         ### # ### # # ### # ### # ####### # ##### ### # # # ### ##### # # # # # ### # # ##### # ### ### # #
         #   #     # #     #     #         #     #     #   #     #     #   #   #     #   #     #   #     # #
         ###################################################################################################