
         ###################
         #     #         # #
START-->   # ### # ### # # #
         # #     #   # # # #
         # # ####### ### # #
         # #   #   #   #   #
         ##### # ##### # # #
         #     # #     # # #
         # ##### # ##### # #
         # #   #   #     # #
         # # # ### ####### #
         #   #   # #   # # #
         # # ### # # # # # #
         # #   # # # # #   #
         # ##### ### # # ###
         # #   #     # #     <--END
         # # # ### ### #####
         # # #   # # # #   #
         # # ### # # # # # #
         #   #   #   #   # #
         ###################