
         #####################
         #   #   #     #     #
         # # # ### # # # ### #
         # #   #   # # #   # #
         # ##### # # ##### # #
         # #     # #     # # #
         # # # ### # ### # # #
         #   # #   #   # # # #
         ####### ##### # # # #
         # #     #     #   # #
         # # # # ####### ### #
         #   # # #     #   # #
         # ### # ##### ### # #
         #   # #     #   # # #
         ### # ######### ### #
         # # #     #   # #   #
         # # # # # # # # # ###
         # # # # #   # #   #   <--END
         # # # ####### ##### #
START-->     #       #       #
         #####################