
         ###############
         #             #
         # # ######### #
         # # #   #   #   <--END
         # # # # # ### #
         # # # #   #   #
         # # # ##### # #
         # # # #     # #
         ### # # ##### #
START-->     # # #     #
         # # # #########
         # # #         #
         # ########### #
         #             #
         ###############