
         ###############
         #       #     #
         # # ### # # # #
         # #   # # # # #
         # ### ### # ###
         #   #   # #   #
         ### # # # ### #
         # # # #   #   #
         # # # # ### ###
         #   # #   #   #
         ##### ####### #
START-->     # #   #     <--END
         # # # # ### # #
         # #   #     # #
         ###############