
###############
#   #     #   #
# # ### # # # #
# #   # #   # #
# # # ##### # #
# # #     # # #
# # ##### ### #
# #   # #     #
# ### # # #####
# #   # #     #
# # ### ##### #
# #     #   # #
# ####### ### #
#         #   #
###############