
###############
# #         # #
# # # # # # # #
#   # # # # # #
##### # ### # #
#     # #   # #
# # ### # ### #
# #   # #   # #
# ### # ### # #
# # # #   #   #
# # # ### # ###
# # #   # #   #
# # ##### ### #
# #       #   #
###############