
         ###############
         #   #       # #
         # # # ##### # #
START-->   # #     #   #
         # # ##### #####
         # #       #   #
         # ### ##### # #
         #   #     # # #
         ### ####### # #
         # #         #   <--END
         # ########### #
         #   #   #   # #
         # # # # # # # #
         # #   #   #   #
         ###############