
         ###############
         #   #         #
START-->   # # # ##### #
         # #   #   #   #
         # ### ### #####
         #   #   #     #
         # # ##### ### #
         # #     # #   #
         # # ### #######
         # # # #     # #
         # # # ##### # #
         # #   #   #   #
         # ##### # #####
         #       #       <--END
         ###############