
         ###################################################################################################
         #                   #           # #                         #             #                 #     #
         # ########### ### ### # # ##### # # ### ########### ######### # ### ##### # # ############# # # # #
         # #       #   # # #   # #     #   #   # #         #   #     # # # #     #   #   #         # # # # #
         # # ##### # # # # # ### ##### # # ### # ##### ### # # # ### ### # ##### # # ### # # ##### # ### # #
         # #   # # # # #   # #   #     # #   # #     # #   # # #   #     #     # # #   #   # #     #     # #
         # ### # # # ##### # # ### ##### # # # ##### ### ### # ### # # ####### # # ########### # # ####### #
         #   # #   #     # # #   #   #   # # # #   #   # #   #     # #       # # # #         # # #       # #
         ### # ######### # # # # ### ####### # # # # # # # # ####### # ##### # # ### ####### # # ##### ### #
         #   #   #     # # # # # #   #     # # # # # #   # #     #   # #     # #   #   # #   # # #   # #   #
         # # ### # # # # ### ### # ### # # # # # # # ##### ####### ##### # ### # # ### # # ### # # # ### # #
         # # # # # # # #     #   # #   # # # # # # # #     #   #   # #   # #   # #   #   # #   # # #     # #
         # # # # # ### # ##### ### # ##### ### # # ### ### # # # # # # # # # ####### ##### # ##### # ##### #
         # #   #   #   # #   #   #   #   #     # #   #   # # #   # #   # # #         #   #   # #   # #   # #
         # ######### # # ### # # ####### ####### # # ### # # ############# ############# ### # # ##### # # #
         #       #   # # #   # #         # #   # # #     # # #       #   #             #   # #   #     #   #
         # ##### # ### # # # # ########### # # # ########### # ##### # # # ### ####### # # ####### # #######
         #     #   #   #   # # #       #   # #   #         # # #   #   # #   # #     # # #   #     # #     #
         ##### # ### ### ##### # ##### # ### ##### ####### # # # ### ### ### # # # # # ##### # ####### # # #
         #     #   #   #   #   #   #   #   #       #   #   #   #   # #   #   #   # # #       #   #   # # # #
         # # ######### ### # ####### ##### # ####### # # # ####### ### # # # ##### # ########### # # # # # #
         # # #     #   #   #       #     # # #     # #   #       #     # # # #   # # #   #   # # # #   # # #
         # # # ### # # # ######### ##### # ### # # # # # ####### ######### # # ### # ### # # # # # ####### #
         # # # #   # # #   #   #   #   # #     # #   # #       # #   #     # #     #     # #   # #     #   #
         # ### # ### ##### # # # ### # # # ##### ##### ####### # # # # ### # ############# # # # ####### ###
         # #   # #   #   #   # #   # # # # #   #     # #     # #   # #   # #         #     # # #       # # #
         # # ##### ### # ####### # # # # # ### # ### # # # # # # ### ### # ### ##### # # ### ##### # # # #   <--END
         # # #   #   # #       # #   #   #   # # #   #   # # # # #   #   #   # #   #   # #   #   # # #   # #
         # # # # # # ######### # ########### # # # # ####### # ### ### ##### ### # ####### ### # # ####### #
         # # # # # # #         #   #     #   # # # #     #   #   # # #     #     # #     #     # #     #   #
START-->   # # # ### # # # # ##### # ### # ### # # ####### ##### # # ##### ####### # # # ### ### ####### # #
         # # # # #   # # # #     # #   # # #   # #       # #     #   #   #       #   # #   #   #         # #
         # # # # # # # # # # ### # ##### # # ### # # ### # # ######### # ####### ##### # # ### #############
         # #   #   # # # # #   # #       #   #   # # #   # # #         # #     #   # # # #   #         #   #
         # ######### # # # ##### ############# ### ### ### # # ######### # ####### # # # ### ### # ### ### #
         #     #   # # # #     #       #   #   #   #   #   #   #       # #       # #   #   #   # # # #     #
         ##### # # # # # ##### ##### # # # # ### ### ####### # # ####### # ##### # ### ### ### # # # # #####
         #   #   # # # # #   #     # #   # #   # #   #     # # # #       #     # #   # #   #   # #   #     #
         # # ##### ### # # # ##### ####### ### ### ### # # # ### # # ########### # # ### ### # # ######### #
         # #     #     # # # #   # #     #   #   # #   # # # #   # #         #   # # #   #   # # #   #   # #
         # ##### # ####### # ### # # # # ##### # # ##### # # # ### # ##### ### ### # # ### ### # # # # ### #
         # #     # # #     #   #   # # # #   # # #   # # # # # #   # #   # #   #   # # #   #   #   # # #   #
         # ### ### # # # ##### ##### # # # # ### ### # # # # # # ##### # # # ### ### ### ### # ##### # # ###
         #   #   # # # #     #       # # # #     #   #   # # #   #     # # #   # # #   #   # # #   # # #   #
         ### ### # # # ##### ########### # # ##### # # ### # ##### ##### # ### # # # # ### # ### # # # ### #
         #   #   #   #     #     #   #   # # #     # # # # # #     #     # #   #   # # # # #     # # #     #
         # ##### ######### # ### # # # ### # # ##### # # # # ####### ##### # ######### # # ####### # #######
         # #   #   #     # #   # # # #   # # # #     #   # #   #   #   #   #     #   # # #     # # # #     #
         # # # ##### # # # ### # ### # # # # # ########### # # # # ### # ####### # # # # ##### # # # # ### #
         #   #       # #   #   #     # #   # #             # #   #     #       #   #   #       #   #   #   #
         ###################################################################################################